### Maze size
10 10

### Maze
1  1  1  1  1  0  0  1  1  1
0  1  1  1  1  1  0  1  0  1
0  0  1  0  1  1  1  0  0  1
1  0  1  1  1  0  1  1  0  1
0  0  0  1  0  0  0  1  0  1
1  0  1  1  1  0  0  1  1  0
0  0  0  0  1  0  0  1  0  1
0  1  1  1  1  1  1  1  0  0
1  1  1  1  1  0  0  1  1  1
0  0  1  0  0  1  1  0  0  1

### First cell
0 0

### Last cell
7 5